广州市东轩食品有限公司	纯正白连蓉,金装白连蓉,清香白连蓉	东轩
梅县石扇镇科涛水果专业合作社	沙田柚	科涛+拼音+图形
梅州市惠兴米业发展有限公司	君惠丝苗米	君惠+图形
惠东县伦信农业有限公司	甜玉米	梁化牌甜玉米+图形
广州市洲星食品有限公司	马蹄粉	洲星+图形
潮安县朝阳农业开发有限公司	潮州柑	朝陽盛+拼音
广州市果树科学研究所	番荔枝,番木瓜	粤好+图形
潮安县祥盛果蔬专业合作社	珍珠芭乐（台湾番石榴）	朝陽盛+拼音
惠州市四季绿农产品有限公司	瑶寨菜心,瑶寨大白菜,瑶寨芥菜,瑶寨芥蓝,瑶寨上海青（白菜）,瑶寨小白菜	四季绿如蓝+图形
韶关市曲江区田园绿色农场	园子鲜菜心,园子鲜芥兰	园子鲜+图形
茂名市名园农业有限公司	荔枝,龙眼	荔皇+拼音+图形
韶关市冠华食品有限公司	银丝米粉	冠益+拼音
连州市金色田园农业开发有限公司	上海青白菜	蒲麓小村+拼音+图形
湛江市金丰糖业有限公司	白砂糖	银月牌+图形
梅州市金稻实业有限公司	农夫山水晚籼米	梅江桥+拼音+图形
茂名市正绿菜业有限公司	菜心,冬瓜,番茄,甘薯苗,麦菜,南瓜,青瓜,水东芥菜,甜玉米,通心菜,小白菜	水东正绿+拼音+图形
广东聪明人集团有限公司	奇异果果汁饮料（猕猴桃）	聪明人、图形
罗定市旺家农业有限公司	稻康大米	稻康+图形
新兴县龙圣茶业食品有限公司	菩提绿（绿茶）,袈裟红（红茶）	龍圣+图形
徐闻县前山糖厂有限公司	白砂糖	赛古+拼音+图形
梅州正佳农业发展有限公司	酥穗优质大米	酥穗+图形+拼音
大埔县嘉美蜜柚农民专业合作社	红芯蜜柚	嘉美蜜柚+拼音+图形
兴宁龙威农业发展有限公司	龙威绿柚	龙威
怀集县华天达生态果业有限公司	沙糖桔	華天達+拼音+图形
广东霸王花食品有限公司	黑米米排粉,河源米粉,淮山米粉	霸王花+拼音+图形
封开县曙光粮食加工厂	贺江米（大米）	贺江
广东顺兴种养股份有限公司	太子妃名柚	星奇泰
广州麦芽有限公司	麦芽（澳麦）	MY
罗定市连州茶业发展有限公司	连州绿茶	白马碧翠
汕头市粮丰集团有限公司	金丝香米,胜泰香米	粮丰+图形
佛山市顺德区龙江镇左滩兴莹水产养殖场	草鱼（活）	左滩+图形、右滩+图形
东莞市佳和农产品有限公司	优威尔脐橙,优威尔沙糖桔	优威尔+图形+拼音
河源市创始人农业发展有限公司	原创人风味炒栗	原创人+英文+图形
梅州南台果业有限公司	平远慈橙	南台缘+拼音+图形
广东福海饼业有限公司	白莲蓉月饼	裕海+拼音+图形
湛江三角威力神酿酒集团有限公司	威力神酒32%vol,威力神酒40%vol	威力神+拼音+图形
郁南县天祥茶园	雁鹰山蜜香茶（绿茶）	雁鹰山+拼音
东莞市塘厦远昌果场	荔枝	昌堂
广东省中山食品水产进出口集团有限公司	宝平草鱼（鲜活）,宝平鳙鱼（鲜活）,鲮鱼肉片（冰冻）	宝平+拼音+图形
珠海斗门绿美水果专业合作社	珍珠芭乐（番石榴）	珍美+图形
徐闻县恒福糖业发展有限公司	白砂糖（一级）	赛古+拼音+图形
龙川县上坪金丰水果实业有限公司	金柑	金丰+图形
梅县九龙山矿泉饮料有限公司	饮用天然矿泉水	梅珍+英文、MEIJOU
广东金岭糖业集团有限公司	一级白砂糖,优级绵白糖	甘岭+图形
廉江市绿色新桂荔枝产销有限公司	荔枝	早桂+拼音+图形
高要市活道镇仙洞益群粉葛专业合作社	粉葛	活仙葛
饶平县永嘉食品工业公司	野山枣糕	四佰岭+拼音+图形
湛江金鹿实业发展有限公司	玛珥大鹿场酒	玛珥大鹿场
海丰县供销果蔬加工厂	皇斋虎噉金针菜（干）	皇斋虎噉+拼音+图形
广东嘉唛食品有限公司	压榨一级纯正花生油	嘉唛
雷州市恒大制糖有限公司	白砂糖（一级）	雪仙+拼音+图形
阳江海纳水产有限公司	巨石斑鱼（冰鲜）,巨石斑鱼（鲜活）,军曹鱼（冰鲜）,军曹鱼（鲜活）,美国红鱼（冰鲜）,美国红鱼（鲜活）,青石斑鱼（冰鲜）,青石斑鱼（鲜活）,深海金鲳鱼（冰鲜）,深海金鲳鱼（鲜活）	海纳新鲜+英文
徐闻县正茂蔬菜种植有限公司	长丰二号红茄,翠秀辣椒,富顺青瓜,金优油青苦瓜,新育大椒,粤农节瓜	祥茂+拼音
怀集高山青农产品有限公司	新岗冻顶茶（乌龙茶）,新岗挂绿茶(绿茶),新岗美人茶(乌龙茶),新岗红茶	新岗大稠顶
梅州市荣胜水果贸易有限公司	沙田柚	十记金柚+图形
 汕头市启兴萝卜专业合作社	胡萝卜	启兴+图形
遂溪县大华糖业河头有限公司	白砂糖	金坡+拼音+图形
汕头市濠江区金寿茶厂有限公司	铁观音（茶）	金寿+图形
阳江市诚泰农业发展有限公司	玉荷包荔枝	锦生+拼音+图形
饶平县长香茶厂	长香单丛茶	长香润
德庆县德润茶叶有限公司	德润红茶（1966）,德润红茶（经典）,金山绿茶（黄罐）,金山绿茶（精制社前茶）	金德润+拼音+图形
郁南县富康农业发展有限公司	郁南粉葛	郁江+拼音+图形
广东翔顺象窝禅茶有限公司	象窝红茶,象窝绿茶	象窝+图形
恩平市聚泉农业有限公司	翠锦圆龙眼,龙眼干	翠锦圆+图形+拼音
惠州市惠汝甜玉米农民专业合作社	甜玉米	惠粒
广州大丘有机农产有限公司	仙蜜果（火龙果）	大丘+GH+图形
东莞市厚街桂冠荔枝专业合作社	荔枝	大迳+图形
东莞市仙津保健饮料食品有限公司	豆奶饮料	仙津+英文+图形
信宜市钱排供销社三华李专业合作社	钱排三华李	钱排李+图形
高州市晟丰水果专业合作社	高州荔枝,高州龙眼,香蕉	仙贡福
高州市永兴生态农业发展有限公司	荔枝,龙眼	红荔果+图形+拼音
连州市连正农业发展有限公司	连正菜心	连正+拼音
梅州市凤山茶业有限公司	梅尖银毫茶（绿茶）	梅凤+图形
广东飞天马实业有限公司	乌龙茶	飞天马+图形
广东收获罐头食品有限公司	糖水菠萝罐头,糖水菠萝全圆片,糖水菠萝碎块,糖水菠萝碎米,糖水菠萝小扇块	三叶牌+图形
英德市横石水镇明辉种养专业合作社	节瓜,苦瓜,丝瓜	江山明辉+图形
广东丹霞天雄茶业有限公司	丹霞岩红·红茶	丹霞天雄
湛江华资农垦糖业发展有限责任公司	白砂糖（一级）	三环+图形
广东梅县梅雁蓝藻有限公司	螺旋藻片	梅雁
梅州市稻丰实业有限公司	客家丝苗米（大米）	金良稻丰+图形
湛江市欢乐家食品有限公司	菠萝罐头（长条）,菠萝罐头（全圆片）,菠萝罐头（扇形片）,菠萝罐头（旋圆片）	欢乐家+拼音+图形
东莞市华美食品有限公司	双黄纯白莲蓉月饼	华美+拼音+图形
广东正茂农业科技有限公司	万有引力锌米	万有引力+图形
广东志诚食品有限公司	玉米粒罐头	XingHeng+图形
梅州市春连农业科技有限公司	春连金柚	好运连+图形
丰顺县恒茂农民专业合作社	火龙果	埔寨火龙果
惠东县黑珍珠莲雾白花农场有限公司	黑珍珠莲雾	图形
惠州市万盛园林有限公司	红肉火龙果	滨海南山+拼音+图形
广东中兴绿丰发展有限公司	星路比葡萄柚,尤力克柠檬	OPTIONS
连州市龙坪镇孔围蔬菜专业合作社	龙旺荣记牌连州菜心	龙旺荣记
连州市丰裕农业科技有限公司	连州菜心	丰农裕+拼音
连州市益农蔬菜专业合作社	九陂牌连州菜心	九陂+拼音+图形
潮州市建成农业综合开发有限公司	香橄榄	图形
潮州市吉云祥茶业有限公司	吉云祥单丛茶	吉云祥+拼音+图形
丰顺丰联绿色食品有限公司	八乡云雾茶（炒青绿茶）,八乡云雾茶（红茶）	八乡云雾
阳西县西荔王果蔬专业合作社	火龙果,荔枝,荔枝	西荔王+图形+拼音
广东省红江农场	红江橙	红江+拼音+图形
雷州市恒祥制糖有限公司	白砂糖	雪仙+拼音+图形
广东省徐闻县大水桥糖厂有限公司	白砂糖	赛古+拼音+图形
阳江市恒荣昌投资实业有限公司	无核荔枝	孖寳+图形
电白县嘉农兴茂农业有限公司	马铃薯,水东芥菜,西红柿..	家茂
广州交易会三千尺贸易有限公司	三千尺饮用天然矿泉水	三千尺+英+图形
雷州市唐家糖厂有限公司	白砂糖	雪仙+拼音+图形
雷州市雷高糖厂有限公司	白砂糖	雪仙+拼音+图形
湛江甘化糖业有限公司	白砂糖	金坡+拼音+图形
熙和集团有限公司	熙河湾沙田柚	熙和湾+拼音+图形
英德市上茗轩茶叶有限责任公司	上茗轩红茶	上茗轩+图形
连州市金山水晶梨果场	水晶梨	秀源+图形
电白县丰泽水果蔬菜专业合作社	荔枝	拼音+图形
阳江市北桂园农业科技有限公司	红蜜薯	北桂园+拼音+图形
广东宝桑园健康食品有限公司（广东宝桑园健康食品有限公司食品厂）	桑果汁	宝桑园+英文+图形
乐昌市沿溪山茶场有限公司	沿溪山白毛茶（绿茶）,沿溪山白毛尖（绿茶）	雾翔+图形
广东开兰面粉有限公司	糕点用小麦粉（特级糕点粉）,面包用小麦粉（特级面包粉）,小麦粉（特级月饼粉）	开兰+拼音+图形
汕头市江畔农业科技有限公司	火龙果	江畔红+图形+拼音
汕头市玉路火龙果种养专业合作社	红心火龙果	玉路+拼音+图形
新丰县城丰蔬菜贸易有限公司	菜心,芥菜,芥蓝,奶白菜..	少丰
连山壮族瑶族自治县民族食品有限公司	菜心,荷兰豆,茄子	壮瑶家香+拼音+图形
饶平县凯斯达农业专业合作社	岭头单丛茶	听雾
东莞市生态林业科学研究所	火龙果	莞林+拼音+图形
罗定市稻香园农业发展有限公司	榃香粘,澳丝米,澳丝粘,桂香粘	聚龙+图形+拼音
广东裕茂农业开发有限公司	台湾翠玉蜜枣,台湾番石榴,台湾紫玉火龙果,裕茂黑珍珠莲雾,裕茂红宝石芒果,裕茂金星杨桃	图形
广东威龙经济发展有限公司	肇实（芡实）	羚羊峡
揭阳市大南山台农种养加工有限公司	东方美人乌龙茶,冻顶乌龙茶,金萱乌龙茶,蜜贵妃乌龙茶	吟鸿+拼音+图形
南雄市金友粮油食品加工有限公司	贡米（大米）,粤香王（大米）	金友+拼音
广东荔宝酿酒有限公司	余甘子酒（半干型）	荔宝+拼音
潮州市潮安区凤凰南馥茶叶有限公司	凤凰单丛茶	南馥+图形+拼音
广东茗皇茶业有限公司	茗皇金萱茶（乌龙茶）	茗皇+英文+图形
罗定市粤西米业有限公司	丝苗米（大米）	罗镜+拼音+图形
清新加多利农贸发展有限公司	菜心,芥兰	加多利+英文+图形
饶平金航深海网箱科技开发有限公司	金鯧鱼（冷冻）,鰤鱼（冷冻）	旗头
广东九华马铃薯产业有限公司	马铃薯	九华+拼音+图形
广东省翁源县茂源糖业有限公司	白砂糖	李花+拼音+图形
广州市白云区沙田柠檬农产品专业合作社	沙田柠檬	沙田庆
清远震兴农产品有限公司	巧口脆笋,巧口玉笋,笋干..	巧口
郁南县富康农业发展有限公司	郁南油栗	郁江+拼音+图形
湛江市绿保现代农业发展有限公司	绿保尖椒	绿保农业+英文+图形
化州市润丰种植专业合作社	菜心,番茄,尖椒,节瓜,..	官地潤豐+图形
河源市三友农牧集团有限公司	尤力克柠檬	三牧田
江门市新康虫草有限公司	蛹虫草（干品）	岗州春+图形、康夫人+拼音
茂名市中盈农业科技有限公司	尖椒,水东芥菜,西葫芦	中盈
潮州市中信食品有限公司	杨梅（蜜饯）	佳信
惠州市四季鲜绿色食品有限公司	龙眼干,鲜荔枝	粤农+拼音、四季鲜+拼音
茂名市恒安实业发展有限公司	菜心,芥菜,芥兰,奶白菜..	恒安+拼音+图形
湛江市坡头区金碧种植专业合作社	菜心,尖椒,南瓜,青瓜	金碧喜禾
广东湛绿农业科技开发有限公司	湛绿尖椒	湛绿+拼音+图形
阳江市大开水产有限公司	冷冻虾仁	大开+图形
湛江市坡头区绿健生态农业种植专业合作社	番薯,辣椒,莲藕	优康泰华
深圳市俊隆果菜农业技术开发有限公司	菜心,大白菜,番茄,芥兰..	俊隆洪
乐昌市北乡镇黑珍珠马蹄生产流通专业合作社	北乡马蹄	北土+图形
江门市鸿豪生物科技有限公司	蛹虫草子实体（干）	鸿豪+拼音+图形
中山市神湾镇种养服务公司	神湾菠萝	神湾+拼音+图形
丰顺县八乡山鸿图绿茶发展有限公司	八乡山绿茶	HT+图形
梅州市木子金柚专业合作社	沙田柚	木子+图形
茂名钜园农业有限公司	龙眼	龙博士+图形、图形
汕头市集泰种养有限公司	地瓜,马铃薯	集泰农产品+拼音+图形
惠东县永惠农业发展有限公司	惠东安墩蜜柚	永惠水果+英文
怀集县大岗镇大蜜李研究园	大蜜李	莫氏大蜜
清远市大丰果业有限公司	红肉火龙果	奥丰达
茂名市谷林农业有限公司	苦瓜,麦菜,青瓜	谷林农
广州市增城祥惠香蕉专业合作社	香蕉	祥惠+拼音
广东阳帆食品有限公司	阳江豆豉	阳帆+图形
高州市晟丰水果专业合作社	桂圆肉,荔枝干,龙眼干	晟丰园+图形
信宜市钱排镇年年红三华李专业合作社	钱排三华李	银妃
潮州市玖佰年茶业有限公司	单丛茶	九百年
江门市新会区大鳌有机农业发展有限公司	慈姑,莲藕	大鳌+图形
茂名市建国生态农业发展有限公司	菠萝蜜,火龙果,荔枝,龙眼,蜜柚	圆生生+拼音+图形
罗定市兴云农作物种植专业合作社	粉葛	大凤塘
茂名市圣源现代农业综合开发有限公司	甘薯,黄秋葵,圣女果	--
电白县益农农产品专业合作社	荔枝,龙眼	丞丰
惠东县四季鲜荔枝专业合作社	龙眼	四季鲜+拼音
汕尾市莲苑种植有限公司	玉壶香绿茶,玉壶香乌龙茶	玉壶香+图形+拼音
高州市燊马生态农业发展有限公司	桂元肉	马头
广东天力大地生态农业股份公司	青瓜,水东芥菜,香芹,小..	水东大地
东莞市阿吉科技农业有限公司	阿吉荔枝	阿吉
广东融和生态农业集团有限公司	蓝莓	粤顺景+图形
连州市嘉农现代农业发展有限公司	高山水晶梨,高山圆南瓜,紫心番薯	嘉利园+图形
广宁县惠骏食品有限公司	山茶油	惠骏+图形
广东蓝田农业有限公司	杏鲍菇（鲜）	图形商标
河源富万家农业发展有限公司	富万家原味炒栗	富万家+拼音+图形
广州市从化围兴甜竹笋专业合作社	甜竹笋	从竹
广东梅龙柚果股份有限公司	可口葡萄柚	嘉誉梅龙
广州市从化华隆果菜保鲜有限公司	柑桔	t-one+先一+图形
廉江市龙盛种植专业合作社	廉江红橙	
广州市白云区丰益蔬果种植专业合作社	葡萄	
信宜市智田现代农业科技有限公司	砂糖桔	
湛江东笔架岭农业科技开发有限公司	芥菜,辣椒	
化州市石滩蔬菜种植有限公司	菜心,芥菜,苦瓜,茄子,..	
高州市鸿业种植专业合作社	荷塘龙眼	
茂名市云开茶业有限公司	云开红玉（红茶）	
东源县绿地美生态农业发展有限公司	大果山楂	
广东金友集团有限公司（南雄市金友粮油食品加工有限公司）	贡米（大米）,粤香王（大米）	金友+拼音
潮州市丹桂生态农业科技有限公司	凤凰单丛茶	虫吃剩
广州市花都区俊丰石榴专业合作社	番石榴	裕骏丰+YUJUNFENG
广州市香蜜山生态果庄有限公司	葡萄,猕猴桃,枇杷	旅田香蜜山
湛江桂荣农业科技有限公司	西瓜	
廉江市良田山水种养专业合作社	樱桃番茄	
始兴县顿岗镇广源农业开发有限公司	菜心,小南瓜	顿岗田间
翁源县锦源三华李专业合作社	三华李	锦赐
揭西县雾云大洋茶叶专业合作社	炒茶	
韶关开心农业科技有限公司	菜心,番茄,青瓜	无
揭西县龙源农业科技发展有限公司	沙糖桔,四季龙眼	揭龙+拼音
高州市名富福石榴专业合作社	福石榴,新芝泰火龙果	
广东天亿实业有限公司	韩山岩顶红,韩山岩露茶	韩山岩顶红,韩山岩露茶
普宁市联民蔬菜专业合作社	水瓜,通心菜	
英德市怡品茗茶叶有限公司	英红九号金装（英德红茶）	怡品茗+图形
江门市新会柑之林农场有限公司	新会柑	无
梅州市马图茶业有限公司	马图高山茶	马图
化州市谷林蔬菜种植专业合作社	黄秋葵	无
茂名市谷林农业有限公司	荔枝	谷林农
广东画景饮料有限公司	画景碱性天然矿泉水	
阳西县东水茶业有限公司	黄金芽红茶,曲河红茶,曲河绿茶,英九红茶	东水山茶
丰顺县龙丰农业综合开发有限公司	饮用天然矿泉水	梅珍+英文+图形
中山市陆泉沙生态农业有限公司	陆泉沙西江大米	
丰顺县新东农林专业合作社	高山番薯	无
茂名市电白区华宝种养专业合作社	苦瓜,青瓜	
梅州杉富绿色生态农业发展有限公司	杉富蜜柚	杉富+图形
韶关市曲江慧源果场有限公司	杨梅	悦诚慧源果场
龙川绿油农业发展有限公司	绿优原生山茶油	绿优原生
惠东县中润柑桔专业合作社	春甜桔,山瑶脆柑	中润万福
惠东县新甘香农贸实业有限公司	红薯粉丝,紫薯粉丝	新甘香
连州市甘源农业有限公司	水晶梨	甘源农场
连州市荣记农业发展有限公司	连州菜心	
湛江市乡情农业发展有限公司	冬瓜,南瓜	
 梅州市乐得鲜农业开发有限公司	乐得鲜菜心,乐得鲜苦瓜,乐得鲜小白菜	乐得鲜+图形
阳西县东水茶业有限公司	黄金芽红茶,曲河红茶,曲河绿茶,英九红茶	东水山茶
广州市从化迷城水果专业合作社	七色葡萄,珍珠番石榴,翡翠火龙果	水果迷城
江门市新会区壹号柑种植专业合作社	新会柑	
广东江茂源粮油有限公司	九号仓香米,六号仓香米,五号仓香米	江茂源
广东岭南红橙有限公司	廉江红橙（岭南红）	岭南红
中山市穗浩园米业有限公司	园万丝苗米（籼米）	图形
河源合成米面制品有限公司	河源米排粉,淮山米排粉	绿雅湖
深圳市旺泰佳农业开发有限公司	辣椒,青瓜,生菜,小白菜	旺泰佳+拼音+图形
湛江东海岛经济开发区南池沟种养专业合作社	冬瓜	
广东龙岗马山茶业股份有限公司	本土高山茶,鸿韵红茶	马山
湛江市源泰米业有限公司	源泰稻米	
广州市增城基岗仙进奉荔枝专业合作社	仙进奉荔枝	仙进奉
广州一衣口田有机农业有限公司	原生.活鸡、原生.鸡蛋	一衣口田
广东燕塘乳业股份有限公司	鲜牛奶	燕塘牌
广州仙居果庄农业有限公司	莲雾	从一
	火龙果	
广州市仙基农业发展有限公司	荔枝	仙基
广州市福源有机渔农产品有限公司	福源沙河甲鱼	福源
广州双桥股份有限公司	果萄糖浆、啤酒用糖浆、葡萄糖浆	"双桥+图形牌"
增城市优质米生产基地公司	增城丝苗米	挂绿+拼音+图形牌
广州酒家集团利口福食品有限公司	岭南佳果月饼礼盒、哈密瓜味馅料、纯白莲蓉馅料、纯红莲蓉馅料、蛋黄纯白莲蓉月饼、蛋黄纯红莲蓉月饼、凤梨味馅料、凤梨味月饼、哈密瓜味月饼、金装双黄纯白莲蓉月饼、	
广州市番禺区悦佳水果专业合作社	胭脂红番石榴	悦佳
广州从化新田水果专业合作社	荔枝	粤新田+yuexintian
广州市东轩食品有限公司	纯正白莲蓉、金装白莲蓉、清香白莲蓉	名轩居牌
广东省金饭碗有机农业发展有限公司	生物有机肥	金饭碗+GOLDBOWL牌
广州市从化富农果蔬专业合作社	葡萄	
深圳市南荔王果业中心	荔枝、龙眼	双荔、图形牌
深圳市田之林农业技术开发有限公司	茄子	图形牌
深圳市田之林农业技术开发有限公司	青椒	图形牌
深圳市田之林农业技术开发有限公司	生菜	图形牌
深圳市田之林农业技术开发有限公司	甜玉米（鲜食）	图形牌
东莞市樟木头农业发展总公司	荔枝	樟木头观音绿
东莞市瑞丹生物科技有限公司	虫草子实体（干基质培养）	瑞丹牌
东莞市黄江龙兴荔枝专业合作社	荔枝	龙兴+图形
东莞市杨屋生态农场有限公司	杨屋荔枝	杨屋荔枝
东莞谢岗银峰荔枝专业合作社	荔枝（桂味）、荔枝（糯米糍）	南面银瓶山+图形
东莞市凤山农业科技园经营有限公司	大朗荔枝	大朗
广东大众农业科技股份有限公司	田师傅土壤调整剂	田师傅+TIANSHIFU
东莞市保得生物工程有限公司	复合微生物肥料12%、复合微生物肥料18%、复合微生物肥料20%、复合微生物肥料25%	保得牌
惠州市惠阳区镇隆山顶村荔枝专业合作社	荔枝	山顶村+图形牌
广东海纳农业有限公司	丝苗米	水中鲤+图形牌
惠东县广兴农贸有限公司	马铃薯	平海+拼音+图形
勇记农业开发(惠州)有限公司	菜心、芥兰、白菜	YK牌
惠州市镇隆镇经济发展公司	荔枝	镇隆
惠东县合长红肉蜜柚专业合作社	金朗红柚	
惠州市旺旺农业科技有限公司	番石榴	旺农科+图形
广东中源农业发展有限公司	西红柿、圆椒、大顶苦瓜	美之源+拼音牌
惠州市好收成农贸有限公司	好收成过年米（大米）	萬其+ManKi+MK+图形
惠州市四季鲜绿色食品有限公司	荔枝干	粤农+YUENONG牌
封开县奇香皇果业有限公司	封开油栗（生）	奇香皇+拼音+图形牌
中山神湾镇翠薇禾虫专业合作社	神湾禾虫稻米	神湾+pin+图形牌
中山市东升农副产品贸易有限公司	脆肉鯇(鲜活)	东裕+英文+图形牌
中山市围垦有限公司	香蕉	香山+拼音+图形牌
广东君有饲料有限公司	草鱼配合饲料（101草鱼膨化配合饲料）、草鱼配合饲料（102草鱼膨化配合饲料）、草鱼配合饲料（111悬浮草鱼配合饲料）、草鱼配合饲料（158＃脆肉鲩前期膨化配合饲料）、草鱼配合饲料（168＃脆肉鲩后期膨化配合饲料）	君有、图形牌
佛山市高明区合水镇农业发展总公司	合水粉葛	明翠牌
佛山西江农业生态园有限公司	白菜、菜心、生菜	绿之选+拼音牌
佛山市铁人环保科技有限公司	中量元素肥料（水稻型通用型）	降隔灵牌
佛山市铁人环保科技有限公司	中量元素肥料（蔬菜型通用型）	降隔灵牌
佛山市铁人环保科技有限公司	中量元素肥料（水果型通用型）	降隔灵牌
鹤山市天润万禾蔬菜专业合作社	大顶苦瓜、粉葛、小青瓜	绿源万禾
台山市粮食购销总公司	珍香丝苗米-精品香米（大米）、珍香丝苗米-精品小珍米（大米）、珍香丝苗米-四星（大米）、珍香丝苗米-五星（大米）	珍香牌
鹤山市轩宝农业发展有限公司	菜心、芥蓝、小白菜	轩宝农业+图形
江门市新会区祥益陈皮有限公司	新会柑	冈州祥益+拼音+图形
江门市新康虫草有限公司	蛹虫草、蛹虫草（虫草皇)	岗州春+图形牌
龙川县绿誉农业发展有限公司	绿誉火龙果	绿誉
河源市丹仙湖茶叶有限公司	丹仙湖绿茶	丹仙湖牌
和平县山角乐农场	猕猴桃	山角乐+拼音+图形
东源县船塘镇鲜绿态农场	东源水晶梨	
东源县丽亮板栗种植专业合作社	东源板栗	利亮
梅州市运兴实业有限公司	绿园金柚	绿园金+图形
梅州万川千红农业发展有限公司	红肉蜜柚	万川千红
梅州市梅县区梅松柚果专业合作社	沙田柚	十记庄园+图形
平远县八尺九香果业专业合作社	平远慈橙	嘉乡+JX+图形
梅州市杨文绿有农业发展有限公司	绿有菜心	光兴发+图形
兴宁市盛旺龙眼发展有限公司	龙眼	科都缘+拼音+图形牌
梅州科艺农业发展有限公司	梅州金柚	科涛+拼音+图形
广东李金柚农业科技有限公司	沙田柚	李金柚+拼音+图形
丰顺县五昌种养专业合作社	台湾蜜枣	五昌
广东十记果业有限公司	金柚	十记金柚+图形
饶平县三妙种养有限公司	橄榄	妙妙妙+MIAOMIAOMIAO+图形、月尖+YUEJIAN
饶平县元峰茶业有限公司	岭头单丛茶	古流香+图形牌
饶平县凌旭茶叶有限公司	凉瓜茶	凌旭牌
潮州市肉类联合加工厂有限公司	鲜猪肉	古城农庄+拼音+图形
潮州市潮安区凤凰嘉茗茶叶有限公司	凤凰单丛茶、凤凰单丛袋泡茶	狮涎泉SHIXIANQUAN
广东京明茶叶综合发展有限公司	高山绿茶、红心铁观音（茶）	京明+图形牌
广东佳宝集团有限公司	酸枣糕	佳宝+图形+野牌
广东佳宝集团有限公司	青梅精（原味）（青梅浓缩果汁）、青梅精（蜂蜜味）（青梅浓缩果汁）、青梅丸（原味）（果丹类）	佳宝+清然+图形
揭西县源和农产品有限公司	玉米、西红柿	源和庄园
广东京溪园罐头食品有限公司	甜玉米粒（罐头）	龙江+图形
广东蓝天果蔬农业科技开发有限公司	九制五味美味萝卜、九制五味蒜茸萝卜、九制五味乌榄萝卜、九制五味虾仁萝卜、九制五味香辣萝卜	蓝天果+拼音+图形
广东佳润泰农业开发有限公司	菠菜、菜心、包菜、胡萝卜、芥蓝、春菜、通心菜	Jia+图形
广东绿盈盈农业科技有限公司	草菇	
海丰县公平供销社	生姜	九龙峒+图形
汕头市集泰种养有限公司	胡萝卜、萝卜	集泰农产品
汕头市绿生果园有限公司	潮汕蕉柑	喜圆圆+拼音牌
佛冈县供销合作社嘉华水果专业合作社	紫淮山、丝瓜、菜心、苦瓜	嘉鑫+拼音
连南瑶族自治县益生源山茶油有限公司	金山茶油（一级压榨）	金瑶山+GOLDYAOSHAN牌
广东第一峰茶业有限公司	第一峰云雾茶（乌龙茶）	第一峰+DIYIFENG
英德市纺生粮油种植有限公司	马岭油粘米（大米）	纺生+FANGSHEN+图形
连州市金色田园农业开发有限公司	连州菜心	
连州市高山公诚蔬果专业合作社	连州水晶梨	高山公诚蔬果+图形
连州市西岸镇冲口蔬菜生产农民专业合作社	连州菜心	
连州市连泰农业发展有限公司	连州菜心	
连州市龙坪镇孔围蔬菜专业合作社	连州萝卜	龙旺荣记
连州市高山绿稻米业有限公司	高山绿稻米（大米）	高山绿稻+拼音+图形
始兴县洪源果业有限公司	东魁杨梅	五月红+图形牌
乐昌市九峰镇绿峰果菜专业合作社	柑桔、水晶梨、黄金奈李、蜜桃	九峰山+图形牌
仁化县和而友生态农业有限公司	长坝沙田柚	和粤+heyueshengtai+图形
乳源瑶族自治县祈泰农业发展有限公司	乳源瑶山杨梅	番泰行+图形
翁源县绿丰园农民专业合作社	红肉火龙果	绿丰园
始兴县美青农业发展有限公司	白菜、豆苗、菜心、芥蓝	美青行
广东鹰峰食品有限责任公司	冰糖芦荟	鹰峰牌
广东大华糖业有限公司	白砂糖	金坡牌
广东恒福糖业集团有限公司	白砂糖	雪仙牌
广东省华海糖业发展有限公司	白砂糖	豊+图形牌
广东省华海糖业发展有限公司	蒸青绿茶	勇士+YOMCSHI+图形
广东省华海糖业发展有限公司	蒸青绿茶、蒸青绿茶（春茶）	雄欧+图形
广东省廉江水果企业集团公司	廉江红橙	廉江红牌
广东省丰收糖业发展有限公司	白砂糖	峰泉+图形牌
湛江市麻章区长荣种养专业合作社	黄秋葵、菜心	久鲜荣
廉江市日强种植专业合作社	廉江日强荔枝	姗姗红
湛江科茂农业科技有限公司	菜心、青瓜、黄秋葵	
广东北部湾农产品批发中心有限公司	岭北菜心	绿绿
湛江市平岭农产品加工厂	火龙果	清壹色+图形+拼音牌
廉江市石城红岭荔枝专业合作社	廉江荔枝	一骑红+YIQIHONG+图形
雷州市绿苗农业发展有限公司	菜心、西瓜	秾丰+图形
廉江市青平管政红橙种植专业合作社	红橙	
湛江康星蔬果有限公司	番薯、番茄、黄瓜、尖椒、芥菜、茄瓜、小白菜、芋头、菜心、大白菜	康星+拼音
雷州市绿富种植农民专业合作社	精选尖椒	绿富强
湛江市博泰生物化工科技实业有限公司	虾肽氨基酸叶面肥（含氨基酸水溶肥料）	博泰botai+图形
茂名市金信米业有限公司	贵族香油粘(米)	锦旺+拼音+图形牌
电白县绿缘绿色食品有限公司	水东芥菜、青刺瓜	华搂大顶+HLDD+图形牌
广东粮丰园食品有限公司	金装白莲蓉、金装红莲蓉	粮丰园
茂名市茂南区永盈果业种植场	荔枝、龙眼	果情浓
广东省新华农场茶叶公司	华煌绿茶、华煌红茶	华煌+图形
广东广垦热带农业公园有限公司	番石榴、红杨桃	图形+MF牌
高州市分界镇刘启钦蔬菜专业合作社	高州麦菜（油麦菜）	
广东杨氏农业有限公司	储良龙眼、妃子笑荔枝	绿杨参
高州市丰盛食品有限公司	荔枝、龙眼、桂圆干、荔枝干、桂圆肉、四季豆	桂康一号牌
海亮生态农业高州有限公司	辣椒、番茄、水果黄瓜	
高州市中港食品冷冻有限公司	麦菜、大白菜	
高州市金龙果业科技有限公司	储良龙眼	岭南益微SOD+图形
高州市华峰农畜果业发展有限公司	荔枝、四季蜜树菠萝	高丰+拼音+图形
广东源丰食品有限公司	芒果酱、淮山	粤旺
电白县沙瑯镇瑞枫家庭农场	小白菜	
电白县沙瑯镇瑞枫家庭农场	菜心	
茂名市电白县丰泽水果蔬菜专业合作社	荔枝、龙眼	茂名泽丰园
茂名市电白县丰泽水果蔬菜专业合作社	芥菜、菜心、芥兰、大白菜	ZEFENGYUAN+图形牌
阳西县上洋华龙西瓜荔枝专业合作社	荔枝	洋冠红玉荷包+图形
阳春市裕茂农业开发有限公司	台湾翠玉蜜枣	图形商标牌
阳西县粤富水产养殖鱼粉有限公司	龙眼	资源富+拼音+图形牌
广东丰多采农业发展有限公司	丰多采1号青瓜（黄瓜）、丰多采1号薯（番薯）	丰多采+FondosFruit
广东粤森生态农业科技有限公司	锦栗番薯	粤森
罗定市现代农业开发公司	马铃薯	九仔牌
云浮市云安区农丰农业综合开发有限公司	贡柑、西瓜	云雾山+图形牌
郁南县富康农业发展有限公司	庞寨黑叶荔枝、郁南无核黄皮、郁南无核沙糖桔、郁南竹笋	郁江+YUJIANG+图形牌
罗定市长岗坡食品有限公司	腐竹	长岗坡渡槽+拼音
罗定市永巨农产品专业合作社	黄豆	
广东省徐闻县全国绿色食品原料（菠萝）标准化生产基地	菠萝	
郁南县人民政府（广东省郁南县全国绿色食品原料（沙糖桔）标准化生产基地）	沙塘桔	
广东省罗定市全国绿色食品原料（水稻）标准化生产基地	水稻	
广东省丰顺县全国绿色食品原料（甘薯）标准化生产基地	甘薯	
广东省大埔县全国绿色食品原料（大埔蜜柚）标准化生产基地	大埔蜜柚	
